#########################E###
########....FFWFF.#######.###
######...########.#####...###
######.##########.#####.#####
######...#...P....#####.#####
########...#.####.#####.#####
############.####.#####.#####
S.......G....####.......#####
#############################
